1110111111111
1C11000h000C1
1111111111111