1111111111111
101C000000C11
1100011E11001
1P01100000001
1111111111111