1111111111111
1C11000000001
11P0000000001
10000000000E1
1111111111111